


###########################>########################>###########################
#                                                                              #
#                                                                              #
#                                                                              #
#  @                 %%%                                                       #
#     #                                                                        #
#   $ #                                                                        #
#    $#############                                                            #
#   $ #    E % % % %       #                     E                   E         #
#  $  #             #                                                          #
#                    #                                                         #
#                                                                              #
#                                                                              #
#                                                                              #
#                                                                              #
################################################################################