

#######################################################################################################################



   @     >
#     #
#   $ #
#    $##############
#   $ #    E        #                     E                   E
#  $  #             #
#                    #
#
#######################################################################################################################