

###########################>####################################################
#                                                                              #
#                                                                              #
#                                                                              #
#  @                                                                           #
#     #                                                                        #
#   $ #                                                                        #
#    $#############                                                            #
#   $ #    E        #                     E                   E                #
#  $  #             #                                                          #
#                    #                                                         #
#                                                                              #
#                                                                              #
#                                                                              #
#                                                                              #
################################################################################