


########################################################################################################################

                  #############
                  # %%%%
                  #
                  #
                  #
                  #  $$$$$$
                  ############

######




#####################


########################################################################################################################