


################################################################################
#                                                                              #
#                                                                              #
#                                                                              #
#  @                                                                           #
#                                                                              #
#   $                                                                          #
#                                                                              #
#   $ #    E        #                     E                   E                #
#  $  #             #                                                          #
#                    #  ########################                               #
#                                                                              #
#                                                                              #
#                                                                              #
#                                                                              #
####################################################>###########################