


################################################################################
#                 %%%%%%%%%%%%%%%%%%%%%%%                                      #
#                                                                              #
#                                                                              #
#                                                                              #
#                                  #########################                   #
#                                  #                       #                   #
#                                  #                       #                   #
#                                                          #                   #
>                                E                  &      #                   >
#                                  #                       #                   #
#                                  #                       #                   #
#                                  ########################                    #
#                                                                              #
#             %%%%%%%%%%%%%%%%%%%%%%%%%%%%%%%%%%%%                             #
################################################################################